                  
    
                                        
          
1111111111111111

1111141242434
4141414
41414141414444
  4141441414141
34111
