        
             
   
111111
100101
101101
1100N1
111111
