NO ./path_to_the_north_texture
SO ./path_to_the_south_texture
WE ./path_to_the_west_texture
EA ./path_to_the_east_texture

F 220,100,0
C 225,30,0

1111111     111111
1000001     1000001
1000001     1000001
10000011111110000011111111111111111111111111111111111111111111111111111
10000000000000000000000000000000000000000000000000000000000000000000011
1N00000000000000000111111111111111111111111111111111111111111111111111
10000000000000000000001
11111111111111111111111













