NO ./texture/bluestone.xpm
SO ./texture/greystone.xpm
WE ./texture/mossy.xpm
EA ./texture/redbrick.xpm
F 153,255,15cc3
C 153,204,255

        1111111111111111111111111
        1000000000110000000000001
        1011000001110000000000001
        100100000000000000000001
111111111011000001110000000000001
100000000011000001111111111111111
11110111111111011100000010001
11110111111111011101010010001
11000000110101011100000010001
1000W000000000001100000010001
10000000000000001101010010001
1100000111010101111101111000111
11110111 1110101 101111010001
11111111 1111111 111111111111
