NO ./texture/bluestone.xpm
SO ./texture/greystone.xpm
WE ./texture/mossy.xpm
EA ./texture/redbrick.xpm
F 0,0,0
C 0,0,225

1111111     111111
1000001     1000001
1000001     1000001
10000011111110000011111111111111111111111111111111111111111111111111111
10000E00000000000000000000000000000000000000000000000000000000000000011
1000000000000000000111111111111111111111111111111111111111111111111111
10000000000000000000001
11111111111111111111111













